1111111111111111111111111111111111111111111111111111111111111111
1000000000000000000000000000000000000000000000000000000000000001
1000000000000000000000000000000000000000000000000000000000000001
1000000000000000000000000000000000000000000000000000000000000001
1000000000000000000000000000000000000000000000000000000000000001
1000000000000000000100000000000000000000000000000000000000000001
1000000000000000000100000000000000000000000000000000000000000001
1000000000000000000100000000000000000000001000000000000000000001
1000000000000000000100000000000000000000001000000000000000000001
1000000000000000000100000000000000000000001000000000000000000001
1000000000000000000100000000000000000000001000000000000000000001
1000000000000000000100000000000000000000001000000000000000000001
1000000000000000000100000000000000000000001000000000000000000001
1000000000000000000100000000000000000000001100000000000000000001
1000000000000000000100000000000000000000000000000000000000000001
1000000000000000000100000000000000000000000000000000000000000001
1000000000000000000100000000000000000000000000000000000000000001
1000000000000000000100000000000000000000000000000000000000000001
1000000000000000001111111111111111111111111111111111000000000001
1000000000000000000000000000000000000000000000000000000000000001
1000000000000000000000000000000000000000000000000000000000000001
1000000000000000000000000000000000000000000000000000000000000001
1000000000000000000000000000000000000000000000000000000000000001
1000000000000000000000000000000000000011111111111111111111000001
1000000000000000000000000000100000000000000000000000000000000001
1000000000000000000000000000100000000000000000000000000000000001
1000000000000000000000000000100000000000000000000000000000000001
1000000000000000000000000000100000000000000000000000000000000001
1000000000000000000000000000100000*00000000000000000000000000001
1000000000000000000000000000100000000000000000000000000000000001
1000000000000000000000000000100000000000000000000000000000000001
1000000000000000000000000000100000000000000000000000000000000001
1000000000000000000000000000100000000000000000000000000000000001
1000000000000000000000000000100000000000000000000000000000000001
1000000000000000000000000000100000000000000000000000000000000001
1000000000000000000000000000100000000000000000000000000000000001
1000000000000000000111111111111111111111111110000000000000000001
1000000000000000000000000000000000000000000000000000000000000001
1000000000000000000000000000000000000000000000000000000000000001
1000000000000000000000000000000000000000000000000000000000000001
100000000000000000000000000000000000000000000000000000000000-001
1000000000000000000000000000000000000000000000000000000000000001
1000000000000000000000000000000000000000000000000000000000000001
1000000000000000000000000000000000000000000000000000000000000001
1000000000000000000000000000000000000000000000000000000000000001
1000000000000000000000000000000000000000000000000000000000000001
1000000000000000000000000000000000000000000000000000000000000001
1111111111111111111111111111111111111111111111111111111111111111